#########S##########
#..................#
#..................#
#..................#
#..................#
#..................#
#..................#
#..................#
#..................#
##########E#########