#S##################################################################################################
#..#....#.##.##...#....#.#.#.#..#.#.#.............#.##.#..##......#.#.#.#.....##.#.##.##.##.#.##.#.#
##.##.#....#..###...##...#.#.##.......###.#######.#.##.##..#####.##.#.....#####..#.....#.##.#..#.#.#
#..#######...##.#######.##.#..#############.....#...##.###.##....##.#.#####.#.##...##.##..#.#.##...#
##.#.#.#.###......##.#..##.#.##.#....#...#..###.###.##.#....####.##.#.##.#....##.#..###..##....#.###
##.#.........#.##....##.##.#.##.#.##...#...##...###.#..####................##.##.#######.#..####.###
#..######.##.#####.#....##.#.##.#..##.####.#..#.......##..#####.###.##.########...#.#.##...##..#...#
##.##.#...######.######..#.#..#.####..##...#.#######.##..##..####...#.....##.##.###...####..##...#.#
#...#.#####.##.#.....###...#.##..##..##..#.#.#........##..##.#.#######.####.....#...###....####.####
###...#.##...#.#####..##.#....##.#..###.##.########.#.###.##.#..##.#........#####.########...##.#.##
#.###.#.####.#.#.#.##.##.##.#.##.#.##.###..####.##..#......#.##..#.##.########......#.#.#..#.......#
#........##..#.#.........##.#....###..######.#.....###.###....##.#.##.#..#.#.#.######.#.#.######.#.#
########..##.#.##.#.#.##..######.####.#.###....#####.#.#...##...........##.#.#......#.#.#.#.#.######
######.#.##....########..##......#.#..#.#.##.####.#....###.#..#.##.#.#.###.....####.#...#.......#.##
#...........##.#....####..#.#.##.....##.#.#####.....######.#.##.#..###.#.#.##########.#...#######..#
########.####..###.##.##.######..#.#......#.#.########.....#######.#####.#.........##.##.#####.##.##
#........#####.##..#...####...##.#.###.####.#.#.##.#.########.##.....##....####.##.#..#####..#.#...#
######.###......##...####.##.#######....#.#..........#.##.#....####.#####.##.########.#.#.##.....###
###....##..###.#####.#..#..#..#.#.#####.#.####.#####......####..#.#.#.##...#.#.#..#.#........#.###.#
#...#.####.#....#.#..##.##.#.##....#......#.####.#######.##.###.#.#.#..###.#.....##.##.###.#.###...#
##.############.#.##.##..#.#..####...##.#.#.#.#.....##..........#.#...##.#...###.#......#######..###
####.#.##.#.#.........##.#.##...#########.#...####.############.....#.#....#######.####....##.##.#.#
#.##......#.##.##.#.#.......###.#.###..#..###.#.##.##...........##.#####.#..#...##.##.####.##.##.#.#
#..######......##.####.#.##..##...#.##.##..#........##############.#.##..####.###.......####..#....#
##...##.########..##########..###...##..##.#######.##.##.....#.#.#.#....###.#.##..#######.###.##.###
#..#......##.######.#.#.#....##.##.####.....####.......#####.#.#.#...##...#.#....###..#.#..#..#....#
#######.#.......##......####.##.##.#######.##..#######.##.#........########...####...##.#.##.##.####
###.##..####.##########.##...#......##........##.##.......########.##.##.##.###..#.#.##............#
#......###....#.#.......####...##.#..##.#.#.#.##..######.##............#.##.#.#.##.####.###.########
#.#.#.##.####.#.#####.#...###.######..#######.###....##...#########.####.#..........#.#.###........#
#######..........##.###.#.#...#..#.##.######......#.##..#...#.........##...####.#.#.......##.#.###.#
#.......#.######........#...#.##...#..#.#.#..#.####.#..####.##.####.#....#....#.#.#.#.#.#..#.#..##.#
####.##.###.######.#.#####.##.####.##.#.....####......##.#.....#....#.#.###.#.###.################.#
#....##.##.........#.#.....#..#.........#.#.#.#####.#.#....##.##.#.##.###.###.##....##..###.#....###
#.##..###..##.##.#.##################.#.#.#.#..######.###.##...#.#.#.......##..##.#..#.##.....#.####
#..##...##.#...######.######.#.#......###.#.##.....######.###.#######.####..#.###.##......#.#.#..#.#
#.####.######.###................#.##...#######.##..##....#....##.#.#.##.######.#.##.#.#########...#
#.#.####..#.#.#...#.#.###.########.#..####.#.######.#..#.##.#.##.............##.#..###.....#.#.##.##
###.#.###.....##.######...##.......##.#......#........##.#..#.###.#.#.#########.##..##.#.#......#.##
#.......##########.#.#..#.#..#.##.########.#...#.##.#.##.##.#..##.#.#...#####.#..#.###.###.#.##.#..#
#######.#.##.#.##......###############.##..##.#####.#.##.#..#.#####.#.#.........##.##....#.#######.#
#..........#.#.#..#.####.#.##.#.##.##.....#####.....#..#.##.#.##....#.##.#.#.##..#####.###.....##..#
##########.#.#.########.........#.....##.###.#..##.###.###..#.###.#.#.##########...##...##.###..####
##.##..........#.#.#..#########...#.#.####.....##...##.####.###.###.#....##.##.#.#####.###...##....#
#..#..##.#.#.#.....##...#.###.###.###.#.####.#..#####....##.#.......##.#....##.#.....#.#...#.##.####
##.###############....#............####......##.#.#...#####.###.##.##..#.##....#.#######.#.#.##....#
#...###.#.#.#.#....#.###.###.##.##.#.######.#####...#...#.#.#####...##.#..##.###.......#####.##.#.##
#.#.............#.##.#...#....#.##.#........##....#.##.##.###.....###..#.##...####.#######....###..#
####.###.#.###.########.##.##.###..#######.######.#.#.......#.#.#..#########.##.##.....#.##.#...##.#
##.###...#.#####...##...#..#..##..#####.....#.##..#.##.#.####.####........##.#...#.#.#...####.###..#
#......#####.##..#....#.##.#.##..###..####.##..##.#.##.#..###.##.##.#.##.##....#.#######..###...#.##
#.##.####.......############..####.##.......##....#..####...#.#.....#.##.##.#.##......#####.########
###..#..#######.#......#.....##.......##.##.#..#.###.#....#####.#.#.#..####.####.##.###............#
#######..##.....######...#.#..####.#.##...#.##.#.##..##.#....######.##.#..#....#..#.....#.#.########
#...#.##....#.###......###.##.###..#..##.#####.#.#..##..##.#..##.#...#.##...#.##.##.#.#.#.#........#
#.#....############.###########.##.#.##..#.##..####.###.#..####....#.#.##.#.###...#.#.#.###.########
#.#.##...###....##..#............#.#####.#....##..#.#.#.##...##.#.##.#..#.#..##.#.#.#####.....#.##.#
########...####....######.######.....##..##.#.###...#...#..######.##.#.#####.######.....###.###....#
##.#.#...#......##.#......#####..#.#####.##.#.#.######.###......#.##.#...##...##.##.#.###.......##.#
#..#.#.#####.##..#####.##.#.....##..##....#####......###...#.######..##.###.#.....#.#...##.#.#.#####
##.#.####.....####.....######.#.##.#####.##.....##.#.....#.#...#.###..#.#.#.###.#####.########....##
#.....#.##.#.###...##.##.#.####.####.....#..#.#.##.#.#.#.###.#....##.##.#....##.##.#......#.###.#..#
#.#.#......#.##..####.#..........#####.#.#.####.##.#####..##.##.####..####.####....##.#.#.....#.#.##
########.###########..##.#.###.#.#.....###.#.##.##.##....##..#.....##..##...##..#.###.#.##.#.##.#..#
#..#.#.####.##.###...##..#.#...#.##.#.##...#....#...##.#..##.#.#.#.##.#####..#.##...#.###..#..###.##
##...............###.#..##.###.#.##.#.#..####.#.##.###.#.##..#.#.###.....##.##.##.#.#..##.######...#
#..#.#.#.##.####...#.##..#.#...#..######.#....#.#..#...#.#####.#..###.####..##..#####.##.....#.###.#
#.####.#######...#...##.##.###.#.###.....##.#.#.####.#.###.##..##..##....##.##.###.....#.#.###...#.#
#.#.#..#.......#.###.##..####..###.##.##.#..###.##...#..##....##..####.#.#..##.##..#.#.###.....#####
###...###.#.##.#.#...#..###.##.....##..####..#######.#.##..##..##.##.#.####..#.###.#.###...#.#...###
#...#.#.#.###..#.##.###.#....#.#.#..########..##.....#..#.##..##.....#...###.#..##.#...###.#.#.#...#
###.###...#########.##..####...#.#.##..#.#.####..##.###.#..##.##.#.###.###...####..#.###...#.###.#.#
######..###..........######..#.#.#####...#......###..##.#.######.#...#.#.###..##..##...###.#..##.###
#.#....##...####.#.#.##.....##.#....####...##.####..##..###......#.#.#.....#.####.#..#..##.#.#######
#...##.##.#####..#.#.###.#.###.#.####.#..###..#....###.########.##.#.##.####..#.#.##.#.#####.......#
##.##..#####....##.#...###.##..#.##.....####.##.####.......##....#.#.##....##...#..#.#.....#.#.#.#.#
########.#...#.##..#####....####..####.###...##.#....##.######.###.#..##.#..##.###.###.#.#######.###
#.#.#.#....#.#.###...####.#..##..###...##..#..####.#.##...##.....###.###.##.#....#..##.#.....##....#
#.....####.#####...#...##.##..##.#.###.#..##.##....#.##.#..###.#.#.....#######.####.##.##.#.####.#.#
#####........#####.#.#..###..##..#.....#.##...#.#.##.##.####...####.#.####........#.#..####...##.###
#..##.#.##.###.....####..###.#..####.###..##.##.#.#..##.##...#..##..#....######.######..##..#.##.###
##....####...#####..##..##...#.##....#...##..##.####.##..###.##..####.##...##........##..##.###....#
#####.##...#.##.#..####.#..#.#########.#.###.##.#....#..##...###...##.##.######.###.##..##..#...#.##
#.##...#.#.#.#....##.#..####.##.#.#....#..##..######.##.#..#..##.####.##...##.....#.##.########.#..#
#....#.#.#.####.#....##.#....#......#.##.####..#.#...##.#.###.##....#..##.##..#.#####....###....#.##
#.#.##.######.###.##..######.##.#.#.#.##..##..##.###.##.#.#...##.#######...##.#....##.#.##...##.#..#
#.#.##....##.......####......##.#.#.###..##..##......##.###.#..#.......##.##..##.#..###..#####..#.##
#.######.######.#.###.##.#.#.######..##.##..####.#.#.#..##..##.#.#.#.###...##..####..##.####...##..#
###......##.....#.##...#.#####.#....##...####....#.#.##..##.####.###.#####..#.###...##..#....#..##.#
########.######.#.##.#....##...###.###.#....####.#.#.###.#..#.....####.#.##.#.#...#.###.#.##.#.##..#
#.........##....#.#..#.#.#####.......#.##.#.#....###.#.####.#####.........#######.#...#.#..#.#..##.#
###.#.#.#####.#.########.######.#.#.#######.####.##......##.#.....#.####.###.##...#.###.#.##.##.##.#
#######.##.#..#.##.##.....##..###.#...##.#####....##.#.####.##.##.#...##.....###.##.##..#.####..##.#
#..#.......##.#.#.....##.####.....##.##...##...#.##..#..##..##.#..#.#.##.##.##...##..##.#..##..###.#
##.###.###.#..####.##.##...##.###.##..###.#..#.#.##.##.###.##..#.##.####.#...#####..#####.##..##...#
#........#.##..#.###..###.#####...######....####..#.####...#####..#####..#.#.....##....##..##..###.#
#####.##.###..##.####..##.#.....#..##.#..##.##...##....###...####.....####.#.##.##..#.##..##..####.#
#.....##.##..##....#..######.##.##....##.#...##.####.###...###....#.#....###.##.###.#..######..#.#.#
##.##.##.##.##..##...##......##.#..#.##..##.##...##..##..#...##.#.#.#.#.##...##..##.##......##...#.#
##################################################################################################E#