#S####################################################################################################################################################
#.......#.##.#.#...##.....#.#.#..##.#.##..#.##.#..##..#.##..##.....#.##.#.##..##......##.#.#.#.......#.##.#.#.##..#.##.#..##..#.##.##...##..##....#..#
##.####.#.##.#.##.##..###.#.#.#.##..#..##...##...##..##.#..#######...##.#.#..###.######..#.#.######.##.##.....#..##.#....###.##.#...##.####..##.###.##
####.#.............#.##...#.#.#..##.#.#####....#####..#.#.##.#...##.##..#.##.#.#......##.#....###......####.#...###.##.###.#..#.###....#..##.#..##...#
#......##.######.#...#..#.....#.##..#.#.##..##..##...##.#.##.###.#..##.##.##.#.#.######....####.######.#.######.#.#.##...#...##..#####...###.#.####.##
#.##.#.####..#######.##.##.##...###.....######.#####.##.#..#.#.....###.....#.#.....##.####..#.#..#.#.......##.#.#.#.#..###.####.##..#..###...#.#.#...#
#.######.###....#....##.#..#..#..##.##.##.##.#.#.....#....##.#####.#.#####...#.######.#.##.##.##.#.###.##.##......#...##.#.##.#..##.##.#.###.#.....###
###..........##...#.############.....###.....#.#####.###.###..##.......#####.#...###..#.#..........######.###.#.#...###....#..##.#..##....##.#.#####.#
##..#.#.#.##..#.#.#.##......##.##.##..##.###....####.###.#.#.#########...##..#.###...##.##########...##.#...######.##.##.###.##..#.##..####..#.......#
#..########..####.#######.#..#.######.#####..####....#.#.#.#..##..#..###.###.#.#.###..#..####.#.####..#.#.########.##.##..##..##....##....##.#.#.#####
####.#..##..##.#..##.#.#..##....###....##.##.#.##.##...#.#...####.##..##.#.....#.#.#.##.##..#....#.#.##....##.#.#..##....##..####.#....#.###.#.#####.#
#.#....##..###.##.#....##.###.#.#.###.##........###..#...##.##.#..###.##.#####...#.#..#..##.####.#.#..##.#..#.#.##.##.#####.##..####.#.###.#.#..#..#.#
#.#.#.######.#..####.#....#...###.#.#..###.####..##.##.#....##.#.##...##.....##.##.##...##..#..#...#.#####.##.#.......#.#.#..##...####.###...#.##.##.#
#.###.#.##...##.##.##########..#......##.....##############.##.#..###.######.......#..#####.##.###.#.#.##.....#######...#...####.##.#..#.###.........#
#..#..#.####.##.##.##...###.##...###.####.####.#####.###.......#.##....##.####.#.###.###..#.##.##..#.#..#####.##.#..#.###.###..#.#..##....#..##.######
##.##.#.#.#..#..##..###......##.##....##..#..#.#.##....##.####.#.#####.##......#..#..#.##.#..#.###.#.#.##......#.##...#.#...##.....##..##.#.#####.#..#
#...#.....##.##..#.##.####.#....#..##..##.#.##.#..##.###..#.......#.##..##.###.##...##..#.##.#.#.....#..#.####.#.###.##.#.#######.####.#........#.#.##
##.##.#####..#..##......##.##.####.###.........#.###.#.####.###.###.###.###########....##.#..#.#####.#.#####.........##......###..##.####.#######....#
#...#.##..##.##.#######..#.#####....########.###.##..#.#.####...#.#..##.#.##.....#####..#.#.##.#.###....##.#########.##.######.#.###..#......###..####
###....#.##..#..#.#.##..####.#.######....###.#.#..##.#.#....###.#.##....#.#..###...###.##......#.#.#.####..#.............#.#.#.#.#.##.###.####.##....#
###.##....##.##.#....##..##.....#.##..##.....#.#.###.#.#.##.#...#.#####...########.#....##.#####.#.#....##.##########.####...#.#...##.......##.##.####
#....######.....####.###.####.#......#######.....#.#...#..#####.....###.####...#.....##.##.#..##.#.#.####..##.##.##.#.##.##.##.###..#.###.####.##.#..#
####...##...#.#...#...##...#####.###.#..####.##.##.###.##..##.###.###.#..#.###.#######...#.#.##......#..##.##.#..#..#.##.##.##.##..######....#.##.#.##
#..#.############.##.#####.#.#.###.#.##.#....##.##.###....##...##.##..#.##.##..#.#.#####...#.######.##.##...#.##.##...##..#.##..##.#.##...####.##....#
##....##.#.#.#.....#.#.##..#...###.####.####.#####.#.##.#..###.##.###.#.......##.....##..#....##..#.....###.#.##..###.#..##..#.##.....###...##.#..####
#..####..#.#.###.#......##...###....##........##.#.#..#.##.....##.#...#####.#..#####.######.#..##...#####.#.#.#..###..##.###...###.####...####...##.##
##.#..##.#.#..########.#####.#.####.####.###.##....#.########.##..###.....####........###.####.####..##...#.#...##.##.#...###.##.#.#.#..#####..####..#
#....##......##.##.....##.#....##....######...#.####..###.##...##.##..######.###.##.#..........#.#..#####...###..#.#..###..#...#.#.....###..##.#..#.##
##.#########.#..##.#.#..#.####.####.##.##...#....##..##....##.##...##.#.###..#################...##..#.#..###.##.#.##.#.##.##.##.##.##.....##..#.##..#
##......##...##.#######.........#.......#.###.######.####.##..##.###..#.#.##.#....###..#.##..###.##.##...###.......##...#..##.##..###..#.###..##..##.#
#..##.######.....##.#.####.####.######.#####..##......##..###......##.#.#.#....####.##....#.##......##.####..#.#.#..###...###.#..###..#######....##..#
##..#####.#..##.##..#.#.#####...#.......##.##.###.#######..##.##.####.#.#.###.###.#..####....######..#.###..#######.#.###..#....##.##..###..##.#####.#
###..##...##.#...#.##...#.#.###.#######.#..#..#.#......##.###.#..#.#.......##.#.#.##.#####.#.....#..##...####.#.###...#.##.#.#####.##.##.#.##...#.##.#
#.#.####.#######...##.#...#.............##.##.#...###.##....####...###.#####.......#....########...###.###.##....#..#......#.#.##......#.#..##.##.#..#
#.#.#.#...#.#....#..#####.#############.....#.###.#.###..######..#.#....##.#.##.##.####.#.#.#.####......#...####.#########.#.#.#..##.###.#.##..#..#.##
#.....###...######.###.#..##..#.#..#.######...##.....###.#..#.##.####.###..#######........#.....#..######.####...###.......#.#.#.#####.#.#..##.#.##..#
#####.##..###...#..#.#.#.####...##.#...##...#..##.####.#...##..#..##....##.##......#.####.##.##.#.##...##..#.#.#.....#.#.#.....#...###...#.##.....#.##
#.#.#..##...###...##.#....#.###....#.#..######....#.##.###..##.#.###.#####..######.###.##.#####...##.#..#.##.####.#.##########...###.##.##.###.##....#
#.#...##..###.###.##.##.#...###.##...##........##.#..#.#.#.###...#.#.#.##..##.#.#####......##.###.#####........######...#...##.###...#..##.#.#.#######
#...#..##.##..##.....##.##.##.####.#.###########....##.#.#.#.#.#.#.....###.......##.#.####.##..##.#.#...##.#####.#.####...#..#..####...##........###.#
##.###..#..##.###.#.#####.....##.#####.##.#########.##.#.#.#.###.#.#####.#####.#..#.###.#..###....#.###.####.##.......##.###...##.####.####.######.#.#
##..###.##..#.#...####.####.###..##.#..........#.##.##.#.#.#..##.....###.#...###.##..#..##...####.#.##...##..####.########.###.##..###..#.#.##.#.#.#.#
#..##....##.#.###.##....#.#.#.##.##.##########......##.......###.#####.#.#.#.##...##.##.##.###......##.#####..#.#.##.##.##..#...#.##...##..........#.#
##..####..#.#.#.#.#####..........##.###.#.##.#.#.##.########.#.#.#.#.#.#.###.###.##..........####.#.##.##..##.....##.##..##.###.#..##.##..##########.#
#########...#.#.#..#.##########.##..#.....##.######.......#....#.#.#.#.#..#..#.#.#########.####.###.#.....###.###.#...##.##.#...#.##...##.##.##.#.##.#
#.........#...#.#.##.#..#####.#.###.#####.#..##.#...#####.##.###.#...#.##.##.#...#.#.#.#....##...#..##.####.###.#.###.#..##.###.#.###.##..##..#...##.#
###.#.#######.#...##.##.........#.#.##....##.##.#####.#....#..##...###.#..##.###.#.#...##.######.##.........##....#...##.##.#.#.#.#.#.###..#.##.###..#
###.####......##.###.##########.#....####.#..##.#.##..####.##.##.#.#.#.##.##.......###....##.#.#.####.###########.###.......#.#.#.#.#..###......#.##.#
#.####.####.#....##..#.#.##...#.####.#.##.##..#.#.###.#....##.##.###.#.#...#######.#.####....#.#.#.......##.....#.#.#######.#.#.....#.##...######.##.#
#..##...#...####..##.#...####...#.##.#.##.###.#.#.#...####.##.#...##.#.#.###.....#........##.#...####.#########.#.#.##.###..#.#.##.##..###..#.##..##.#
##.####.##.##.###.#..###.#.####.#.#.....#.#.......###.#....#....#.#..#.#...#####.#.#.#######...###....##.##.##...........##...####.##.##.#.##.###.##.#
#...#.#.##.#........##.....#.##...#####...######.##...####.#.#######.#...###.##..######..#.###..###.#..#..#.###########.#####.##...##..#...##.#.#.#..#
###.#....##########.######.#.####..###..###.#.#..###.##....#.#..##...###...#.###..#.#.##.#.##..##.###.##.##.#.#...#.##..##....####..#.##.###....#.#.##
#...##.####.##......#.####.#.#.###.#...###....##.#.#.#####.....#####..####.....##.#.#....#.#..###.##..##..#.#.###.#..##.#####.#..##.#....####.#......#
###.##.###.....##.#............#.#.###...####.........#..#.###...#.#.##..##.#.##..#.####.....##....##..##.#.#.##..#.##...##...#.##..#.#.##.#######.###
###.#....##.#####.#####.#.###.##...#.###..#######.###.##.#####.###...##.#####..##...#..###.#..##.###..##....#..##...###.#####....##.#.####.#.##......#
#...#.#####.#...###.#.#######.####.....#.##...######......##.#.#.##.###.##.#..#####.##...####..#...##..####.#.##..#......##...##.##.#..#.#...##.##.###
###...##..#####.##.....##.....#.######.#..##.##..#...####....#.#..#.##.....#.##.#....##.##..##.#.###..##.#..#..#########.#######.##...##.#.######..#.#
#.###..##.###......#.########.#.#........##..###.#####....##.....##.#####.##.##.####.....##....#.#.##.##.##...##.#.###.......##.....#.##....##..##.#.#
#...##......########.#...##.....##.#####..##.#...#.######..####.##...##.#.#..##.##.#####.#####.....##..#..###.#..#.#.######.##..##.######.###..###...#
###.##.####.##.#.#.....######.######.#...##..#.#...#.##.####.#...##.##..#...##..##...#....##.###.#####.#.##...##...#.##.#...######...#.#..#...##.#.#.#
#.#.##...#####.#.####.##.##...##.##....#..##.#####.#.#...#.....###...##...#.###.####.#.#.##......#..##....##.#####......###.#.##...#.#.##.###..#.#.###
#.#.##.###.##..#.##.......##.###....##.##.....##.#.#.###...#.#.#...######.###....##..###..######...#####.###.##....###.##.#.#.####.###.##...##.......#
#...#...#..###...####.###.#....####.#..####.#........#.#.#####.##.##.##.#..#####.###..###.##.##..###..#..##..##.####...##......##...##..##.#####.#####
###.###...##.##.##.####.....#####.######....##.#####.#.####.##.#...#.#..##...##......##......###...##.##.##.######...#..#####.###.###..##..##.##.#.#.#
#...##..#.#..#.....#.######...##..##..###.#.#..#........#......###...##..##.###.#.##..######...##.##..#..##..#.#.######.......##...###.###.##.##.....#
###....#####.#####..........#####.##.##.#########.#####...####.#.###.##.##....######.##......###..###.##.###...#..###.######.##..###.#..#...#.####.###
######..##...###...########..#.#..#..##.##.#..#.####....#.#....#.##..##..##.#..##.....######...##.#...#...##.###.##.......#...##.##..##.##.##.#.##...#
#..##..#####.#.######.......##.##.##.##.#..##.#.#....##.####.#....##..##.##.#.#######..##..###.##.###.#.###..#.#..#####.#...#....##.##..##.#..#.#..###
##..##..#.#..#.#..#.######.##..##.#..##.##.##.#.####..####.######..#.##...#.###...####.###......#.#.#.#.####.#...##..######.###.##...##.##.##.#.##...#
###....##.##...##.....#.....##..#.#.##..##.##...###..##..#..#.####.#.#..#.#..####.#.#...##.#.##.......#.#.##.#.#####.#.#.##.##...##.##..##.#.....#.###
#.####.##..###..#####.#####..##.#.#.#..##..##.###.######.##.#..........#####..##......###########.###.....##.#.#..##......###..#..#..##.##.##.##.#...#
#..###..#.##.##..##.#....###.#........####.##.##..##.....##.##########...##..########....####.#######.##.###.#.##..##.##.###..###...##.....##..#.#.###
##.#.##.#.##.#..##..####..##.##.#.#.#..##......##..#####.##.#.#.#......####.###.###.#.####.#..#.......####.#.#..##.##.#..#.##...###.####.###..####.#.#
#....#..#.##.##..##.#.###.....###.#.##..###.##..##........#.......####....#.#.#.#...#..#.#.##.#.#####..##..#.#.##..#####.#..#######.#.#....##..##..#.#
####.##......##.###.#.#.####.##...#####..##..#.##########...#####..###.####.#...###...##.#.##.####.###..##.#....##.#.#.#.#.####.........##.##.##..##.#
#.#...####.####.#.#.#.#.##...###########.#..#####.##......#.#...#.##.....##.##.######..#...##..#.....#.###...####....#.#.#.##.#########..###...##..#.#
#.###......##.#.#.#.#.#..###..##.##.##.#.##...#.#.###.#.#######.######.####.##.##...##.#.#####.#####.....#.#.#..####.#.#.#.#...#.#.#..##..##.####.##.#
#.##..#.##....#.#.#...##.#.#.###.#..#....#..###.#.#.#######..##.##.##...#.#.##..#.#..#.#..#.#........#######...##.#....#.#.#.###.#.#.####.##..##...#.#
#....##.###.#...#.###.##.#.#.#.#.##.####...####...#..#.#..##.#..##....#...#.#..#####.#...##...######..#..##..#.#..####...#.#..##...#..#.#.#..##..###.#
####..###.#####...##..##...#.#.#.#....####....#.#...##.##.#..##.#####.#.#.....##.##..#.########..#.#.##.##..#####..#.###.#.##.####...##...##..##.#.#.#
#..##.##...#..###.###..###.#.#.#.####...##.########.........##...#.########.###...##.#.#..##..##.#...#...##.#.####..........#..#####.##.#####.##.....#
##.#######.##.........##.#.#.#.#.#.####.#..###.##.#########..###...#.#.##....###.##....#.##..##..###...###.....#.##.#######.#.##.#.#.#...##.#..#.#.###
#....##.#.....###.#.#..........#.#.#.#....##...#..###.#..###.....#.#.#..####...#..##.#.#..##.###...###.##..#####..###.#.#...#.##.#.#.#.###..#.##.#####
####.#..#####.#...#.##.###.###.#...#.###.#####.#.##.#...##.#######.#...##..#.###.##..###.##...#..###....##.#.#.##.##......#...##.#.#.#...##....#.##..#
###..#.##.#.##########.######..###.........##..#....###.##.##.#.#....#.###.#.#.#..##..##.####.##..#..#.###......#.#..###.####.##...#.##.####.###..##.#
#.##.#..#.#..#...#.#...#.##.##.#.#######.#####.#.#.##.#.#.....#...####.....#.#.#.##..###..##..###...#####..######.####.###.#..####.#.#..#.#...##.###.#
#......##.##.###...#.#.#..........##.##...##.#.#.####.#.##.##...##########.#.#.#.##.##.#.##..##.###.#.#.##..##.##...##.##..##..###...##...###........#
#.#.##..#.....####.########.#####.##.###.###.#.#.##.....##..##.##........#.......##..#.#..##........#.#....##..###.##...##.#..##.##.###.####..#.#.####
#.#.###...##.##.#...#.##..###.........#..#.#...#.###.#.##..##..###.#####.###.#.#..##.#...######.###.....#.##..##....##.##..##.##..#.#.#..##..#######.#
#.###...#.#...#.###...###.##..###.###.##.#.###.#.#.###..#####.##.###......#######.##.#.###.#.########.######.######.#...##.......##...#.####...##..#.#
######.######.#..####......#########.......#.#...#..##.##.#.####.#######.##.#.#...#....#.#....##.........#.#.##..#....#..#######..###....##..#####.#.#
#.......###...#.##.######.##.##.##.##.#.##...###.##.##.##...##........#...#.#.###...##...##.#######.#.##......##.###.#####.#.#...##.####..##...##....#
######.##.###......#..#....#.#......#####..#.....#..##..##.#######.##...#.........#..#.###..#..#############.##..#...#.##..#.###.##.##...##..###..####
#.##...#..########.##.####.#.###.##...####.#.###.##....###..##...###..####.######.######...##.##..##.#.#.....###.###.#..##....##.##..###..##.#.#.##..#
#....####.#.#..........#.#.#.#######.##.#######...#.##..#..#####.##..##..###.......##.####.##..##.#....####.##.#.#...##..#.##.#..##.#####.........#.##
#######.#.....###.##.#.............#.#...##.#.###.#####.#.###.....##.###.....#####.....##..###.##.###.###.#.#....#.#..##.####.##..#.##.####.#####.#..#
#.###.#...#.#.##..#..##.#.##.#.#.#...##.##.....##.##.##...#.#####..###.########....###.##.##...##..##.##....#.#######..#.##.#.###....#.#..#.###.#.##.#
#.......#.#.########################.##.####.#........##.##..##.#.##...#..#.....##.#...##..#.#....##..#####...##..#.##...##.#.#.####.#.##.....#.####.#
###.#.#######............#.##.#.##........#####.###.#..#.##.##..#.####.##.############....#######..##..#....#..##....###.##.....##.#...##.##.##..##..#
###.#####.....##########.#.#..#.#######.###.#.########.#.##..##...#.#..#....#.##.##..###.##.#.####..##.#######..####.#...####.####.###....##..##.##.##
#.#.###.##.#.##..........#.##....#.##...##..#..#...#.#.#....#####.#.##.##.#...##.#..##........#.#..###..##.#.#.##.##.###..###..##...###.#######..#..##
#.###.#.##.#########.#.#......##....###..##.##.###.#...#.####.##....##..#.###.##.##..#####.##.#.##.##..##....#.#..#..#.#.##...###.###.....##..##.##..#
#..#....#####........#.########..##.....##..##.#...#.#....##..###.###..##.#...##....##.##..#.......###..##.#.#.##.##.#.#..###.#.#...##.######.##..#.##
##.##.#..##...#.#.#.##.#..#.#######.###..##.#....#.####.#####.......##..#.###..###.##...#########.##...##..#...#..#......##.#.#.#.###....#.#..###....#
#...####..#.#.###########.....###.######.##.######..#.#.##..#####.#....####.#.##....###.#.##..###..#.#.#######.##.#####.##..#.#.#..####.##.##..##.####
#.#..#.#.#######.#.#.#######.##.#.##..#.........###.#......##.########..##.....###.##.....#..##.#.####..###.#...#..#.#..###.#.#...##.#..##..##.##...##
####.#.#.#.#.##......#.#.#....#.#.###.##.######.......#.#####.#.##.#...#######.....######.#.##..#..##..##...###.##...##.#.#.....###....####..#.#..#..#
#........#.#.#..####.#.#.####.#.#.#......#..#.#.#.##.##..##.....##.#.#.#.#..######.#.#.#....###...##..#####...#.####.#....####.##.#.#####.##.....##.##
###.####.#.#.####...............#.##.#.####.#.######.#..#####.####.###...##...##...#.#.##.###.###..##.....###...#.#..####.####.##.#..##.#..###.#######
#...#.........#####.#.#########...##.####.#.#.##.#.####.#.#....##...####..##.###.#.....#...#..####....#.###.###.#.##.##...#..#.##.#.##..#.##.#....##.#
#######.##.##....#######........#..###........##.#.##.#...####..#.###.###..#.##..#####.###.#.##..####.#..#..#......#....#...##..#.#..##.#.#....##....#
#........#######..##.#.#.###.##.##..#####.#.#..#......###..####.....#.#.##.#.#######...##.....##..######.##...#.##...######..##.#...##......#.########
##.##.#.####.##..##......#...######..#.#######...####.#.##.#.#..###...#.##....#.#..#.#..##.####..##..#....#####.##.#.##..###.##.##.##..####.####.##..#
#..#######....##.####.#.###.##.##.##....##.#.##.##.........#.####...#....####.#.##.####.....#.##..##.####.##.#..#..#####........##.###....#..#.#....##
####.#.#.####.......#########........##.........######.###....#######.##....#.#..#.#######.##.#..###..##..#..####.##.....#.#.##.##.#...#######...##..#
#.#..#........#####.##.#.###..##.##.####.####.#.#......######.#.#.#######.#...##.#...#.##..##.##.#.##..##.#.####...############..#.##.##.####..#######
#.##.#.#.##.#.#####.......#..#####..#..###.########.##.#......#.#...##..#.###..#...#.#..##..........##.#.....#.#####....#.#.#.##.#.#......#.##.###.#.#
#.##.##########...#######.####.#######.#...#.#.#.#..#####.###...#.#####.###.##.#.######..##########.#..####.##.#.#.####..........#.#.######..#...#.#.#
#.##.##.##..#####.#.##.#...###.#...#.#.###.#.#.#.####.#########.#..#.#..##.....#...##.##..##.#.##.#.#.##.##.#..#.#..##..#.##.#.#.......###..##.###.#.#
#.##.##....##.##.........#.....#.###...#.#.....#.##....#.#..#.....##.#.#####.#...#.#..###..#.#.##...#.#..#..##.#.#.###.############.####.#.###.#.#.#.#
#.#...####.#.....#.#.#.#######.#.#.###.#.##.##.#..###.##.##...###..#...##.######.###.##.##......###.#.##.#.##..#.#.#.###.#.#..#......#.#.#.#.........#
#.##.###.#...###.#.#.#####..................#....##.#.#...########.###.....###....##.#.....####.#.#.#.##...###.#.#...##....##.#####.##.......##.#.##.#
#.##..#..#############...###.#.#.#.####.##.###.#..#.#.###.#.....#......###.....##..#.####.####........##.#.#.#.#.##.##..##.......##..#####.######..###
#....##.##.##...#.#.####.#.#####.###....##.##..##...#..##.#####.#.####.####.#.####.#.#..####.###.####.##.#.......##.############.##.##..#..#....######
#.##..#.##..###.....#............##################.##.#..#.#.....######.######....#.#.##.....####.##.#########.##...##..#...........##.#.##.#####.#.#
#####....#.##.#.###.#.##########.#..##.#..#.####.#...#.##...#####.#...##.#.#.#####......#####...##.##..##.###.#..###..##.#.########.##..#.#..........#
#.....##....#.###.#.####...#.##..##.#..#.##.#....###......###########.##...........###.##.#####.#.....##......#.##...##..###.#.#.#...##.#...####.###.#
###.#..###.##.##..#.##...#....#####.##....#.####...##.###..##....##....########.##.##.....#.#...####.##..####.#.##.#..##.##......##.###...############
###.#.##....#.###....#.#.#.##........###.##.#.#..########.##..##.#####..##.#.#..##.######.#.###.###...####.##.#.####.##.....####.##.#.#.###......#.###
#...#..####.#.#.#.#.#########.##.###.....##.#.##.#.#.#.....####...#..#.##......##....##.....##....##.##.#..#.....##...#########..#..#.#.....######...#
#.#.####........###.#.#..##.#.#..#...###.............###.#...####.##......###.##..##..##.##.####.###.##.##.#####..##.##....##.##.##...#.#####.#..##.##
#############.###...#.#.##....#.######...###########...####.##.##.#..##.#.#...#..##..######.#.#..#.#.....#.#.....###..####.#..#...#.#.......#.#.##...#
#.......#......####.#.#.#########.########.###########.##.#.##.##...##..#.#.###########.......##.#.#####.#...###.#.##..#.#.##.###.#.#########.#.##.###
#####.#...#.##..##..#.#.#.####.#........#...............#.........#.###########.#..##.###.###.......###..#####...#.##.##.#.#...#..#.##.##.##........##
#.#...#.#.#####.###.#.....#..#.########...##.######.###...###.##.####..##.........##..##....##.#.#.##.##....####....#.##...###.##.#........##.#####..#
#...#.######......#.#####.##.#..##.##.#########.#...#...###...##.#.###.##########..##.#..#########.....###.##..####.#..##.##........#########...#.####
##.##.##...#.####....##.#.##.#.##......###..#.#.#.#.###.#...#.#..#..#..#.##.#.#.#.###...#####...####.#..##..#.##.##...##...########.#..#.##.#.###.####
#...######...#....##..............####.#.##.......#.#...###.#######.##..............##.###..###.#....##.###....#.####..#.#.....##...#.##.#..#..#.....#
###.#......#.##.###..###.#.#.#.#.###.#....###.##.####.#.#...###.#.#..####.#.#.###.#..###.##.##..#######.#.####....##..#######.#####.#......##.##.#####
#...######.#.#######.#...#.###.#.#...###.##....#..#########.#.....#.##....#####...##..##.##..##.#.#.#...#.##.####..##..##.#...##.#..#.######.....#...#
###.##########.##.######.#.##..#####........#.##.##......####.###....####.##.#..#..##.....#.##........#...#.....##..##.#..###.##.##........#.###...#.#
#.###.....#.#..#.........#.######....##.##.##..###..####.#.######.##....###..#.#####..#.#...#..#.#.#.##.#...#.#..#.##..#.##.......##.#######.#.#######
#...##.##.#.##...#.#.#.#.###....###.###..#.#..##...##.............#####.####....##...##.###.##.#####.####.######......##..######.###.##...##.#.##.#.##
##.#####.....###.#.###.#.####.#..#..#...####.#####.##.#.#.######.##..........#.##..#.#####.....##....#....##.##..####..##.#......#.#....###.....#....#
#...#..#####.....###...#.#..####...##.#.#.#####.....#####.###.##.##.#.#.##.#######.#.#.##..#.#.#..#.#####.##..#####...##....####.....##.#.###.###.####
#.#...##.#.#.##.#####.##.##......#.##.#....##...#####.....#.......#####.#..##...######.###.#.#.####.##.##..##.......#....##.#..###.######............#
#.###........#..#.....##.#..###.##.####.#######.###.#.###.#####.#.##....#######.#.#.#......#.#.##...#.....########.###.#.##.##.......#.#..##.###.#####
#.#...##.#.#.#.##.#.#..#.#.##...##.#....##......#.....#...#.....#.##.#.##.............##.#.#.#.##.#.##.#.##........#...#.#...##.##.#.....##....#.....#
####################################################################################################################################################E#