#S################################################
#.#.#.#.##.##.#.#.#..#....##...##.##........##...#
#.....#.#.....#.#.##.###.####.##..#########....#.#
#####.#.#####.........#...##...##.........##.#####
##.##.#.#.#.#########.###.####....#######.....#.##
#...........#.###..........#.#######.#.####.#....#
######.####.....##########.#.#.#.##.........#.##.#
#..#...#.######.##......#........#..#.#####.######
##...###.#......#######...##.###...##.#####......#
#..####....####.#.#.#.##.##..#...#.#..#.....#.####
#####.###.##..........#..#..###.##.#.#####.##....#
#.....#####..####.###...###.##..##.###.....##.####
#####.#.###############.##...#.##########.###..###
#.......................#..###..##....#.....##...#
##.#.#.######.#.##.##.####...##..##.#.###.####.#.#
########......#.##..###....#..#.#####.....#....###
#.#.##...#.##.###########.##.####..###.#.###.#...#
#....###.#.##.#...........##...###..####.#...#.#.#
#.##.....#.##.#####.#.###.##.###.##......#.#.#.#.#
#.#..#.#.#..###########...#...##....#.##.#.#.#.#.#
#.#.##.#.#.###.....#.###.###.######.#..#####.###.#
#.#.##.#.#.#...###.......##...##....#.##.....###.#
#.###..#######.#...#.###..###.##.#.##..###.#...#.#
#.####.#..##.#######.####.#...#..############.##.#
#.#..####.#...#.#.#..#.#..##.###.##..#.#.......#.#
#.##..##....#.......##...##..##...##.....#.#.#.#.#
#####....##.######.#####.#######.####.#.##.###.#.#
##.##.#.#####......##......##.##.#.#..#.##.##..#.#
#.....#.##.#######..#.##.#.##....#...##.######.#.#
##.##.###..........#####.###..##.#.#.#....##...###
#..#..####.#####.###......#####..#.#.##.#.##.#...#
#####.#....#......######.##.....####.#..#.##.#.###
#.#.######.##.#.#....#######.##.#....##.#.##.#...#
#.#.##.##..#..#.##.###.##....##.##.#..###.####.###
#.......#####.#.##.##.....##..#.#..##.#.....##...#
#####.#..##...########.##.#..##.##.##.##.##.#..#.#
#.....##....#...#.#....#..##.#####.##.#..##.##.###
#.#.######.##.###...#.###.#...##....####..#.##...#
#############.###.#####.###.#####.####...##..##.##
#.....##........#.#..##.#...##.....##..#.##.##...#
#.###.###.###.######......#.#..##.####.####.##.#.#
####......#.....##...#.#.#######....##..##..####.#
#....#######.##.##.#.#.#.#.##.###.#####..##...##.#
###.##.......##..#.#.#.#.#.#.........##.####.##..#
#.#####.##.####.##.#.#.#.#...#.##.####...##..##.##
#..#.#####..##..##.###.#.##.##.#.....###.##.##...#
##....##.#.####.##...#.###..#..##.##.#.#..#.##.#.#
###.#........##..##.#####..##.##..##...#.####..#.#
#...##.##.#.##..##...##...##...##..##.##....##.#.#
################################################E#